00000000001101000220201000000001000000101201000000
20022001002101222000100000000000000110000000010000
00100002000002222020001010000000001002002100000000
00000122220000222002000000000220001000000000001100
00000002220001020100000000000100200010000000002000
00000102222000222000000010000000000000201000002100
02222000000100222000000010022200000000002221100000
00222200100000222000000000022222001000000000102000
00222200000000000000010010122222200000000102101020
00222200200000022220000000022222201212200000002000
20022202000200222222222100222022210002220000000000
00000000012202222222222000222222200022222001002222
01000000000022222222222002222222200012222100002222
00001200000002220000222000121222210002222002002222
00220022220002220000000000222022222002220011001001
01010222200022220000000010100022222020022220000002
10000222220222220020000100200002222200222200000000
00200222020222200002000001000002222000222200200001
01000222200222100100000000001020000001222001000020
00000000101002020000000000002000001020201020001000
00010000020000100020001101000012000110022220000000
00001000000000022220000001010000000001022220000222
02002000000000022220222000002002000010022220000222
00100000000222222220222000000000001000022220000222
00200000020222220002222100000002111000022222010222
20000000000222200022222100100000000000022222200222
11200000200022200222222001000200000010022222000000
00000010002022202222220021000102000020000000010021
20022202000000012222021000000000000200000000100020
00222200000000002220020010000010001200000020000210
00222210101002020002000000022220000000200220000002
00222012010000002000000020222220000000000000100000
00100120002010002000200022222220000000100021000000
00202222000000000000010122222001000022200000020002
00002222000000010211010022221000000222221000000002
00002222102000000222000022220020000222220000000000
00000021000000000222000022220010200222220022100010
00102220202000000222001022202220200022200010001210
00122222001010000002100000022220000002000000000222
10022222020010002220000100022220200200000000100222
00122222002220202220000000022220000022100010221222
21002222012220002220000000002221100000000000000000
10000000122220200200000000002222000000200000001000
00000002022220000000000000210000002000002000000002
00000020022220020200000000000000000200100000102010
01000000002220000000002000010200000000020000000000
10000000000000000000002201021000000000000022200200
00000000020020000000000102221000020100010022202000
00010100110000000000000002222000000001000022200000
00001000020200001010100012220000000000000002202001
